. . . . . . B .
B . . . . . . .
. . . . . . . .
. . . S . . . B
. E . . . . . .
. . . . . . . .
. B . . . . . .
. . . . . . B .
