. . . . . . . . . .
. . . . . . . . . .
. . . . . . . . . .
. . . P . . Q . . .
. . . . . . . . . .
. . . . . . . . . .
. S . p . . q . E .
. . . . . . . . . .
. . . . . . . . . .
. . . . . . . . . .

