. . . . . . . .
. . . . . . B .
. . B . . . . .
. . . . . . . .
. . . . . . . .
. . . E . . . .
. S . . . . . B
. . . . . . . .