. . B B . . . .
. . . . . F E .
. . . . . . . .
. . . . . . B .
. . C . . . . .
. . . . . . . .
. . S . . . . .
. . B . . . . .