. B . . . . . . . . . .
. . . . . . B . . . . .
. . . B . . . . . . . .
. . . . . . . B . . . .
. . . . . . . . . . . .
. . B . . . p . . S B .
B . . . . P . . . . . .
. . . . . . . . . . . .
. . . . . . . . . . . .
. . . . . E . . . . . .
. . . . . . . . . . . B
. . . . . . B . . . . .