. . . . . . . .
. . . . . . . .
. . . . . . B .
. E b . . . S .
. . . . . . . .
. . . . . . . .
. B . . . . . B
. . B . . . B .s