. . . . . . . .
. . . . . b E .
. . . . . . . .
. . . . . . B .
. C . . . . . .
. . . . . . . .
B S . . . . . .
. . . . . B . .