. . . . . . B .
. . . P . . . .
. . . . . . . .
. . . . . . . .
. . . . . . . .
. . . S . . . .
. E . . . . p .
. . . . . . . .