. . . . . . . . . . . .
. . . . . . . . p . . E
. B . . F . . . . B . .
F S . . . F . . b . . B
. . . . . . . . . . . .
. . . . . . . . . . . .
. . . . . . B . . . . B
. C . . . . . . . . B .
. b . . . . . . . . B .
. . . . P . . B . . . .
. . . . . . . . . . . .
. B . . . . . . . . . .