. . . . . . . .
. P . . . . E .
. . . . . . . .
. . . . . . . .
. . . . . . . .
. . . . . . . .
. S . . . . p .
. . . . . . . .