. . . . . . . .
. . . b C . p .
E . . . . . . .
. . . . . . . .
. . . . . . . .
. . . . . . . .
. P . S B . . .
. . . B . . . .