. . . . . . . .
E b b b b . p .
. . . . . . . .
. . . . . . . .
. . . . . . . .
. . . . . . . .
. P . S b b b .
. . . B . . . .