. . . B . . . .
. P . . . . . .
. . . . . . . .
. E . F . . p .
. . . . . . . .
. . . . . . . .
. . . S . . . .
. . . . . . . .