. . . . . . . .
. . . . . . . .
b b . S . b b B
. . . . . . . .
. . . . . . . .
. . . . . . . .
. . . . . . E .
. . . . . . . .