. . . . . . . .
. B . . . . E .
. . . . . . . .
. . . C . . . .
. C . . . . . .
. . . . . . . .
. S . . . . . .
. . . . . . . .