. . . E B . . .
. . . . . . B .
. . . . . . . .
. . . P . . . .
. . . . p . . .
. . . . . . . .
. S C . . F . .
. . . . . B . .