. . . . . . . .
. B . . p . . .
. . . B . . . .
. . . . . b . .
. E B C . . . .
. . . . . . . .
. P F . F . S .
. . . B . B . .