. . . . . . . .
. E . . . . . .
. . . B . . . .
B b . . F . S .
. . . . . . . .
. . . . F . . .
. . B . . . F .
. . . . . F . .