. B . . . . . .
. . . . . . . E
. . . . . . B .
B . F . . . . .
. . . . . . . B
. . . . . . . .
. . S . . . . .
. . . . . . . .