. . . . . . B .
. C C . B S . .
. C . . B . . .
. . . . . C . .
. . b . . . . B
E . . . B . . .
. F . . . . . .
. . . . . . . .