. F . . . . B .
B . . . . . . .
. . . . . . F .
. b . . . . F F
. b b . . F . F
. b b . . . F F
. E b . . S . .
. . . . . . . .